10 10 10 10 10 10 10 10 10 10 10 10 10 10 10 10 10 10 10 10 10 10 10 10 10 10 10 10 10 10 10 10 10 10 10 10 10 10 10 10 10 10 10 10 10 10 10 10 10 10
10 10 10 10 10 10 10 10 10 10 10 10 10 10 10 10 10 10 10 10 10 10 10 10 10 10 10 10 10 10 10 10 10 10 10 10 10 10 10 10 10 10 10 10 10 10 10 10 10 10
10 10 21 15 15 15 15 15 15 15 15 15 15 15 15 15 15 15 15 15 15 15 15 15 15 15 15 15 15 15 15 15 15 15 15 15 15 15 15 15 15 15 15 15 15 15 15 22 10 10
10 10 13 20 20 20 20 20 20 20 20 20 20 20 20 20 20 20 20 20 20 20 20 20 20 20 20 20 20 20 20 20 20 20 19 19 19 19 20 20 20 20 20 20 20 20 20 17 10 10 
10 10 13 20 20 20 20 20 20 20 20 20 20 20 20 20 20 20 20 20 20 20 20 20 20 20 20 20 20 20 20 20 20 20 20 20 20 19 20 20 20 20 20 20 20 20 20 17 10 10 
10 10 13 19 31 19 19 19 19 20 20 20 20 20 20 20 20 20 20 20 40 33 33 33 33 33 33 34 20 20 20 20 20 20 19 19 19 19 19 19 19 30 30 30 30 30 30 17 10 10 
10 10 13 20 20 19 31 19 19 20 20 20 20 20 20 20 20 20 20 40 32 32 32 32 41 32 32 32 34 20 20 20 20 20 19 19 19 18 11 12 19 20 20 20 20 20 30 17 10 10 
10 10 13 20 20 19 19 19 19 20 20 20 20 19 19 19 19 40 33 32 32 41 32 32 32 41 32 32 32 33 34 19 19 19 19 19 19 17 10 13 19 20 20 20 20 20 30 17 10 10 
10 10 13 20 20 19 19 31 19 20 20 20 20 19 19 19 19 38 37 32 32 32 32 41 32 32 32 41 32 37 36 19 19 19 19 19 19 16 15 14 19 20 20 20 20 20 30 17 10 10 
10 10 13 20 20 20 19 19 20 20 20 20 20 19 19 20 20 20 20 38 32 32 32 32 32 41 32 32 36 20 20 20 20 20 19 19 19 19 19 19 19 20 20 20 20 20 30 17 10 10 
10 10 13 20 20 20 19 19 20 20 20 20 20 19 19 20 20 20 20 20 38 32 32 41 32 32 32 36 20 20 20 20 20 20 19 19 19 19 19 19 19 20 20 20 20 20 30 17 10 10 
10 10 13 20 20 20 31 19 20 20 20 20 20 19 19 20 20 20 20 20 20 38 32 32 32 32 36 20 20 20 20 20 20 20 20 20 20 20 20 20 20 20 20 20 20 20 30 17 10 10 
10 10 13 20 20 20 19 19 20 20 20 20 20 19 19 20 20 20 20 20 20 20 38 32 32 36 20 20 20 20 20 20 20 20 20 20 20 20 20 20 20 20 20 20 20 20 30 17 10 10 
10 10 13 19 19 19 19 19 20 20 20 20 20 19 19 20 20 20 20 20 20 20 20 38 36 20 20 20 20 20 20 20 20 20 20 20 20 30 30 30 30 30 30 30 30 30 30 17 10 10 
10 10 13 19 19 19 19 31 20 20 20 20 20 19 19 20 20 20 20 20 20 20 20 19 19 20 20 20 20 20 20 20 20 20 20 20 20 30 20 20 20 20 20 20 20 20 20 17 10 10 
10 10 13 20 20 20 31 19 20 20 20 20 20 19 19 20 20 20 20 20 20 20 20 19 19 20 20 20 20 20 20 20 20 20 20 20 20 30 20 20 20 20 20 20 20 20 20 17 10 10 
10 10 13 20 20 20 19 19 20 20 20 20 20 19 19 20 20 20 20 20 20 20 20 19 19 20 18 11 11 11 11 11 11 11 11 12 20 30 20 20 20 20 20 20 20 20 20 17 10 10 
10 10 13 20 20 20 19 19 20 20 20 20 20 19 19 20 20 19 19 19 19 19 19 19 19 20 17 10 10 10 10 10 10 10 10 13 20 30 20 20 20 20 20 20 20 20 20 17 10 10
10 10 13 20 20 20 19 19 20 20 20 20 20 19 19 20 20 19 19 19 19 19 19 19 19 20 17 10 10 10 10 10 10 10 10 13 20 30 20 20 20 20 20 20 20 20 20 17 10 10 
10 10 13 28 28 28 19 19 28 28 28 20 20 19 19 20 20 19 19 20 20 20 20 20 20 20 17 10 10 10 10 10 10 10 10 13 20 30 20 20 20 20 20 20 20 20 20 17 10 10 
10 10 13 28 26 26 26 26 26 26 28 20 20 19 19 19 19 19 19 20 20 20 20 20 20 20 17 10 10 10 10 10 10 10 10 13 20 30 20 20 20 20 20 20 20 20 20 17 10 10 
10 10 13 28 26 26 26 26 26 26 28 20 20 19 19 19 19 19 19 20 20 20 20 20 20 20 17 10 10 10 10 10 10 10 10 13 20 30 20 20 20 20 20 20 20 20 20 17 10 10 
10 10 13 28 26 26 26 26 26 26 26 19 19 19 19 20 20 20 20 20 20 20 20 20 20 20 17 10 10 10 10 10 10 10 10 13 20 30 20 20 20 20 20 20 20 20 20 17 10 10 
10 10 13 28 26 26 26 26 26 26 28 20 20 20 20 20 20 18 11 11 11 11 11 11 11 11 24 10 10 10 10 10 10 10 10 23 11 26 11 11 11 11 11 11 11 11 11 24 10 10
10 10 13 28 26 26 26 26 26 26 28 20 20 20 20 20 20 17 10 10 10 10 10 10 10 10 10 10 10 10 10 10 10 10 10 10 10 26 10 10 10 10 10 10 10 10 10 10 10 10 
10 10 13 28 28 28 26 26 28 28 28 20 20 20 20 20 20 17 10 21 15 15 15 15 15 15 15 15 15 15 15 15 15 15 15 15 15 26 15 15 15 15 15 15 15 15 15 22 10 10 
10 10 13 20 20 20 19 19 20 20 20 20 20 20 20 20 20 17 10 13 20 20 20 20 20 20 20 20 20 20 20 20 20 20 20 20 20 19 20 20 20 20 20 20 20 20 20 17 10 10 
10 10 13 20 20 20 19 19 19 19 19 19 19 19 19 19 19 17 10 13 20 20 20 20 20 20 20 20 20 20 20 20 20 20 20 20 20 19 20 20 20 20 20 20 20 20 20 17 10 10 
10 10 13 20 20 20 19 19 19 19 19 19 19 19 19 19 19 17 10 13 20 20 20 20 20 20 20 20 20 20 20 20 20 20 20 20 20 19 20 20 20 20 20 20 20 20 20 17 10 10 
10 10 13 20 20 20 19 19 20 20 20 20 20 20 20 19 19 17 10 13 20 20 20 20 20 19 19 19 19 19 19 19 19 19 19 19 19 19 19 19 19 19 19 19 19 19 19 17 10 10
10 10 13 28 28 28 27 27 28 28 28 28 28 28 20 19 19 17 10 13 20 20 20 20 20 19 40 33 33 33 33 33 33 33 33 33 33 33 33 33 33 33 33 33 33 34 19 17 10 10 
10 10 13 28 27 27 27 27 27 27 27 27 27 28 20 19 19 17 10 13 20 20 20 20 20 19 39 32 32 32 32 32 32 32 32 32 32 32 32 32 32 32 32 32 32 35 19 17 10 10 
10 10 13 28 27 27 27 27 27 27 27 27 27 28 20 19 19 17 10 13 20 20 20 20 20 19 39 32 32 32 32 32 32 32 32 32 32 32 32 32 32 32 32 32 32 35 19 17 10 10 
10 10 13 28 27 27 27 27 27 27 27 27 27 28 20 19 19 17 10 13 20 20 20 20 20 19 38 37 37 37 37 37 37 37 32 32 32 32 32 32 32 37 37 37 37 36 19 17 10 10 
10 10 13 28 27 27 27 27 27 27 27 27 27 28 20 19 19 17 10 13 20 20 20 20 20 19 19 19 19 19 19 19 19 19 39 32 32 32 32 32 35 19 19 19 19 19 19 17 10 10 
10 10 13 28 27 27 27 27 27 27 27 27 27 28 20 19 19 17 10 13 20 20 20 20 20 20 20 20 20 20 20 20 20 19 39 32 32 32 32 32 35 19 28 28 28 27 28 17 10 10
10 10 13 28 28 28 28 28 28 28 28 28 28 28 20 19 19 17 10 13 20 20 20 20 20 20 20 20 20 20 20 20 20 19 39 32 32 37 37 37 36 19 28 27 27 27 28 17 10 10 
10 10 13 20 20 20 20 20 20 20 20 20 20 20 20 19 19 17 10 13 20 20 20 20 20 20 20 20 20 20 20 20 20 19 39 32 35 19 19 19 19 19 28 27 27 27 28 17 10 10 
10 10 13 20 19 19 19 19 19 19 19 19 19 19 19 19 19 17 10 13 20 20 20 20 20 20 20 20 20 20 20 20 20 19 39 32 35 19 28 28 28 28 28 27 27 27 28 17 10 10 
10 10 13 20 19 19 19 19 19 19 19 19 19 19 19 19 19 17 10 13 20 20 40 33 34 20 40 33 34 20 20 20 20 19 39 32 35 19 28 27 27 27 27 27 27 27 28 17 10 10 
10 10 13 20 19 20 20 20 20 20 20 20 20 20 20 20 20 17 10 13 20 20 39 32 35 20 39 32 35 20 20 20 20 19 38 32 36 19 28 27 27 27 27 27 27 27 28 17 10 10 
10 10 13 20 19 20 20 20 20 20 20 20 20 20 20 20 20 17 10 13 20 20 38 37 36 20 38 37 36 20 20 20 20 19 19 19 19 19 28 27 27 27 27 27 27 27 28 17 10 10
10 10 13 28 27 28 28 28 20 20 20 20 20 20 20 20 20 17 10 13 20 20 20 19 20 20 20 19 20 20 20 20 20 19 19 28 28 28 28 27 27 27 27 27 27 27 28 17 10 10 
10 10 13 28 27 27 27 28 20 20 20 20 20 20 20 20 20 17 10 13 20 20 20 19 20 20 20 19 20 20 20 20 20 19 19 28 27 27 27 27 27 27 27 27 27 27 28 17 10 10 
10 10 13 28 27 27 27 28 20 20 20 20 20 20 20 20 20 17 10 13 20 20 20 19 20 20 20 19 20 20 20 20 20 19 19 28 27 27 27 27 27 27 27 27 27 27 28 17 10 10 
10 10 13 28 27 27 27 27 19 19 19 19 19 19 19 19 19 26 26 26 19 19 19 19 19 19 19 19 20 20 20 20 20 19 19 27 27 27 27 27 27 27 27 27 27 27 28 17 10 10 
10 10 13 28 28 28 28 28 20 20 20 20 20 20 20 20 20 17 10 13 20 20 20 20 20 20 20 20 20 20 20 20 20 19 19 28 28 28 28 28 28 28 28 28 28 28 28 17 10 10 
10 10 23 11 11 11 11 11 11 11 11 11 11 11 11 11 11 24 10 23 11 11 11 11 11 11 11 11 11 11 11 11 11 11 11 11 11 11 11 11 11 11 11 11 11 11 11 24 10 10
10 10 10 10 10 10 10 10 10 10 10 10 10 10 10 10 10 10 10 10 10 10 10 10 10 10 10 10 10 10 10 10 10 10 10 10 10 10 10 10 10 10 10 10 10 10 10 10 10 10
10 10 10 10 10 10 10 10 10 10 10 10 10 10 10 10 10 10 10 10 10 10 10 10 10 10 10 10 10 10 10 10 10 10 10 10 10 10 10 10 10 10 10 10 10 10 10 10 10 10


1  2  3  4  5  6  7  8  9  10 11 12 13 14 15 16 17 18 19 20 21 22 23 24 25 26 27 28 29 30 31 32 33 34 35 36 37 38 39 40 41 42 43 44 45 46 47 48 49 50

10 3 2 2 2 2 2 2 2 2 2 2 2 2 2 2 2 2 2 2 2 2 2 2 2 2 2 2 2 2 2 2 2 2 2 2 2 2 2 2 2 2 2 2 2 2 2 2 3 3
10 3 2 2 2 2 2 2 2 2 2 2 2 2 2 2 2 2 2 2 2 2 2 2 2 2 2 2 2 2 2 2 2 2 2 2 2 2 2 2 2 2 2 2 2 2 2 2 3 3
10 3 2 2 0 0 0 0 0 0 2 2 2 2 2 2 2 2 2 2 2 2 2 2 2 2 2 2 2 2 2 2 2 2 2 2 2 2 2 2 2 2 2 2 2 2 2 2 3 3
10 3 2 2 0 4 4 4 4 0 2 2 2 2 2 2 2 2 2 2 2 2 2 2 2 2 2 2 2 2 2 2 2 2 2 2 2 2 2 2 2 2 2 2 2 2 2 2 3 3
10 3 2 2 0 4 4 4 4 0 2 2 2 2 2 2 2 2 2 2 2 2 2 2 2 2 2 2 2 2 2 2 2 2 2 2 2 2 2 2 2 2 2 2 2 2 2 2 3 3
10 3 2 2 0 4 4 4 4 0 2 2 2 2 2 2 2 2 2 2 2 2 2 2 2 2 2 2 2 2 2 2 2 2 2 2 2 2 2 2 2 2 2 2 2 2 2 2 3 3
10 3 2 2 0 0 4 4 0 0 2 2 2 2 2 2 2 2 2 2 2 2 2 2 2 2 2 2 2 2 2 2 2 2 2 2 2 2 2 2 2 2 2 2 2 2 2 2 3 3
10 3 2 2 2 2 4 4 2 2 2 2 2 2 2 2 2 2 2 2 2 2 2 2 2 2 2 2 2 2 2 2 2 2 2 2 2 2 2 2 2 2 2 2 2 2 2 2 3 3
10 3 2 2 2 2 4 4 2 2 2 2 2 2 2 2 2 2 2 2 2 0 0 0 0 0 0 0 0 0 2 2 2 2 2 2 2 2 2 2 2 2 2 2 2 2 2 2 3 3
10 3 2 2 2 2 4 4 2 2 2 2 2 2 2 2 2 2 2 2 2 0 0 0 0 0 0 0 0 0 2 2 2 2 2 2 2 2 2 2 2 2 2 2 2 2 2 2 3 3
10 3 2 2 2 2 4 4 2 2 2 2 2 2 2 2 2 2 2 2 2 0 0 0 0 0 0 0 0 0 2 2 2 2 2 2 2 2 2 2 2 2 2 2 2 2 2 2 3 3
10 3 4 4 4 4 4 4 2 2 2 2 2 2 2 2 2 2 2 2 2 0 0 0 3 3 3 0 0 0 0 0 0 0 0 0 0 0 0 0 0 0 2 2 2 2 2 2 3 3
10 3 4 4 4 4 4 4 2 2 2 2 2 2 4 4 4 4 4 4 4 0 0 0 3 3 3 0 0 0 0 0 0 0 0 0 0 0 0 0 0 0 2 2 2 2 2 2 3 3
10 3 4 4 2 2 2 2 2 2 2 2 2 2 4 4 4 4 4 4 4 0 0 0 3 3 3 0 0 0 0 0 0 0 0 0 0 0 0 0 0 0 2 2 2 2 2 2 3 3
10 3 4 4 2 2 2 2 2 2 2 2 2 2 4 4 2 2 2 2 2 0 0 0 0 0 0 0 0 0 2 2 2 2 2 2 2 2 2 2 0 2 2 2 2 2 2 2 3 3
10 3 4 4 2 2 2 2 2 2 2 2 5 5 4 4 5 5 2 2 2 0 0 0 0 0 0 0 0 0 2 2 2 2 2 2 2 2 2 2 0 2 2 2 2 2 2 2 3 3
10 3 4 4 2 2 2 2 2 2 2 5 5 5 4 4 5 5 5 2 2 0 0 0 0 0 0 0 0 0 2 2 2 2 2 2 2 2 2 2 0 2 2 2 2 2 2 2 3 3
10 3 4 4 2 2 2 2 2 2 2 5 5 5 4 4 5 5 5 2 2 2 2 2 2 2 2 2 2 2 2 2 2 2 2 2 2 2 2 2 0 2 2 2 2 2 2 2 3 3
10 3 4 4 4 4 4 4 4 4 4 4 4 4 4 4 4 4 4 4 4 4 4 4 4 4 2 2 2 2 2 2 2 2 2 2 2 2 2 2 0 2 2 2 2 2 2 2 3 3
10 3 4 4 4 4 4 4 4 4 4 4 4 4 4 4 4 4 4 4 4 4 4 4 4 4 2 2 2 2 2 2 2 2 2 2 2 2 2 2 0 0 0 0 0 0 0 2 3 3
10 3 2 2 2 2 2 2 2 2 2 5 5 5 4 4 5 5 5 2 2 2 2 2 4 4 2 2 2 2 2 2 2 2 2 2 2 2 2 2 2 2 2 2 2 2 0 2 3 3
10 3 2 2 2 2 2 2 2 2 2 5 5 5 4 4 5 5 5 2 2 2 2 2 4 4 2 2 2 2 2 2 2 2 2 2 2 2 2 2 2 2 2 2 2 2 0 2 3 3
10 3 2 2 2 2 2 2 2 2 2 2 5 5 4 4 5 5 2 2 2 2 2 2 4 4 2 2 2 2 2 2 2 2 2 2 2 2 2 2 2 2 2 2 2 2 0 2 3 3
10 3 2 2 2 2 2 2 2 2 2 2 2 2 4 4 2 2 2 2 2 2 2 2 4 4 2 2 2 2 2 2 2 2 2 2 2 2 2 2 2 2 2 2 2 2 0 2 3 3
10 3 2 2 2 2 2 2 2 2 2 2 2 2 4 4 2 3 3 3 3 3 3 3 4 4 2 2 2 2 2 2 2 2 2 2 2 2 2 2 2 2 2 2 2 2 0 2 3 3
10 3 2 2 2 4 4 4 4 4 4 4 4 4 4 4 2 3 3 3 3 3 3 3 4 4 3 3 3 3 3 3 3 3 3 3 3 3 3 3 3 3 3 3 3 3 0 3 3 3
10 3 2 2 2 4 4 4 4 4 4 4 4 4 4 4 2 3 3 3 3 3 3 3 4 4 3 3 3 3 3 3 3 3 3 3 3 3 3 3 3 3 3 3 3 3 0 3 3 3
10 3 2 2 2 4 4 4 2 2 2 2 2 2 2 2 2 2 2 2 2 2 2 2 4 4 2 2 2 2 2 3 3 2 2 2 2 2 2 2 2 2 2 2 2 2 0 2 3 3
10 3 2 2 2 4 4 4 2 2 2 2 2 2 2 2 2 2 2 2 2 2 2 2 4 4 2 2 2 2 2 3 3 2 2 2 2 2 2 2 2 0 0 0 0 0 0 2 3 3
10 3 2 2 2 4 4 4 2 2 2 2 2 2 2 2 2 2 2 2 2 2 2 2 4 4 4 4 4 4 4 4 4 4 4 4 4 4 4 2 2 0 2 2 2 2 2 2 3 3
10 3 2 2 2 4 4 4 0 0 0 0 0 0 0 2 2 2 2 2 2 2 2 2 4 4 4 4 4 4 4 4 4 4 4 4 4 4 4 2 2 0 2 2 2 2 2 2 3 3
10 3 2 2 2 4 4 4 2 2 2 2 2 2 0 2 2 2 2 2 2 2 2 2 2 2 2 2 2 2 2 3 3 2 2 2 2 4 4 2 2 0 2 2 2 2 2 2 3 3
10 3 2 2 2 1 1 1 2 2 2 2 2 2 0 2 2 2 2 2 2 2 2 2 2 2 2 2 2 2 2 3 3 2 2 2 2 4 4 2 2 0 2 2 2 2 2 2 3 3
10 3 2 6 6 1 1 1 6 6 2 2 2 2 0 2 2 2 2 2 2 2 2 2 2 2 2 2 2 2 2 3 3 2 2 2 2 4 4 2 6 6 6 6 6 6 6 6 3 3
10 3 2 6 1 1 1 1 1 6 2 2 2 2 0 2 2 2 2 2 2 2 2 2 2 2 2 2 2 2 2 3 3 2 2 2 2 4 4 2 6 4 4 4 4 1 1 6 3 3
10 3 2 6 1 1 1 1 1 6 2 2 2 2 0 2 2 2 2 2 2 2 2 2 2 2 2 2 2 2 2 3 3 2 2 2 2 4 4 6 6 4 4 4 4 1 1 6 3 3
10 3 2 6 1 1 1 1 1 6 2 2 2 2 0 2 2 2 2 2 2 2 2 2 2 2 2 2 2 2 2 3 3 2 2 2 2 4 4 4 4 4 4 4 4 1 1 6 3 3
10 3 2 6 6 6 6 6 6 6 2 2 2 2 0 0 0 0 0 0 0 0 0 0 0 0 0 0 2 3 3 3 3 3 3 2 2 4 4 4 4 4 4 4 4 1 1 6 3 3
10 3 2 2 2 2 2 2 2 2 2 2 2 2 2 2 2 0 2 2 2 2 2 2 2 2 2 0 2 3 3 3 3 3 3 2 2 2 2 6 6 4 4 4 4 1 1 6 3 3
10 3 2 2 2 2 2 2 2 2 2 2 2 2 2 2 2 0 2 2 2 2 2 2 2 2 2 0 2 3 3 3 3 3 3 2 2 2 2 2 6 4 4 4 4 1 1 6 3 3
10 3 2 2 2 2 2 2 2 2 2 2 2 2 2 2 2 0 2 2 2 2 2 2 2 2 2 0 2 2 2 2 2 2 2 2 2 2 2 2 6 6 6 6 6 6 6 6 3 3
10 3 0 0 0 0 2 2 2 2 2 2 2 2 2 2 2 0 2 2 2 2 2 2 2 2 2 0 0 0 0 0 0 0 0 2 2 2 2 2 2 2 2 2 2 2 2 2 3 3
10 3 0 0 0 0 2 2 2 2 2 2 2 2 2 2 2 0 2 2 2 2 2 2 2 2 2 0 2 2 2 2 2 2 0 2 2 2 2 2 2 2 2 2 2 2 2 2 3 3
10 3 0 0 0 0 0 0 0 0 0 0 0 0 0 0 0 0 0 0 0 0 0 0 0 0 0 0 2 2 3 3 2 2 0 2 2 2 2 2 2 2 2 2 2 2 2 2 3 3
10 3 0 0 0 0 2 2 2 2 2 0 2 2 2 2 2 0 2 2 2 2 2 2 2 2 2 0 2 2 3 3 2 2 0 0 0 0 0 0 0 2 2 2 2 2 2 2 3 3
10 3 0 0 0 0 2 2 2 2 2 0 2 2 2 2 2 0 2 2 2 2 2 2 2 2 2 0 2 2 2 2 2 2 0 2 2 2 2 2 0 2 2 2 2 2 2 2 3 3
10 3 2 2 2 2 2 2 2 2 2 0 2 2 2 2 2 0 2 2 2 2 2 2 2 2 2 0 0 0 0 0 0 0 0 2 2 2 2 2 0 2 2 2 2 2 2 2 3 3
10 3 2 2 2 2 2 2 2 2 2 0 0 0 0 0 0 0 2 2 2 2 2 2 2 2 2 2 2 2 2 2 2 2 2 2 2 2 2 2 0 0 0 0 0 0 0 0 3 3
10 3 3 3 3 3 3 3 3 3 3 3 3 3 3 3 3 3 3 3 3 3 3 3 3 3 3 3 3 3 3 3 3 3 3 3 3 3 3 3 3 3 3 3 3 3 3 3 3 3 
10 3 3 3 3 3 3 3 3 3 3 3 3 3 3 3 3 3 3 3 3 3 3 3 3 3 3 3 3 3 3 3 3 3 3 3 3 3 3 3 3 3 3 3 3 3 3 3 3 3


